18,19,19,19,19,19,19,19,19,12
17,1,1,1,1,36,1,1,1,13
17,1,1,1,1,1,1,1,1,13
17,1,36,1,1,28,29,1,36,13
17,1,1,1,36,10,6,1,6,13
17,36,1,2,1,28,29,1,1,13
17,1,1,28,29,1,1,1,1,13
17,1,1,1,1,30,1,2,1,13
17,1,1,1,1,31,1,1,1,13
16,15,15,15,15,15,15,15,15,14
