18,19,19,19,19,19,19,19,19,12
17,10,6,2,1,30,1,1,5,13
17,28,23,29,1,31,1,30,4,13
17,1,1,1,3,1,1,25,4,13
17,1,28,29,9,28,23,17,4,13
17,1,3,3,3,3,1,25,1,13
17,28,15,23,23,29,1,25,1,13
17,8,31,1,1,1,1,25,1,13
17,1,1,1,36,1,5,31,1,13
16,15,15,15,15,15,15,15,15,14
