18,19,19,19,19,19,19,19,19,12
17,5,3,3,5,28,29,10,36,13
17,5,28,29,5,3,5,3,5,13
17,3,5,3,3,5,3,3,3,13
17,3,3,5,3,5,3,3,5,13
17,5,3,3,5,28,29,5,3,13
17,5,5,3,36,3,5,3,5,13
17,36,3,5,3,5,3,5,36,13
17,1,3,3,5,3,5,3,5,13
16,15,15,15,15,15,15,15,15,14
