18,19,19,19,19,19,19,19,19,12
17,1,1,1,9,36,8,30,1,13
17,1,36,4,30,1,5,31,1,13
17,6,2,1,25,1,1,6,1,13
17,1,2,1,31,1,2,30,1,13
17,1,1,2,1,30,1,25,1,13
17,6,2,1,2,25,1,31,1,13
17,4,28,27,27,22,1,4,1,13
17,10,4,4,4,4,1,1,1,13
16,15,15,15,15,15,15,15,15,14
